NO ./textures/path_to_the_north_texture
SO ./textures/path_to_the_south_texture
WE ./textures/path_to_the_west_texture
EA ./textures/path_to_the_east_texture

F 220,100,3
C 225,30,0







  111111111111111
111N11111111111
1100001011100111111111111
1100001010100111111111111111111
11111111111111111111111111111111111
1111111111111111111111111111111111111
