NO ./textures/wall_1.xpm
SO ./textures/wall_2.xpm
WE ./textures/wall_3.xpm
EA ./textures/wall_4.xpm

F 255,204,255
C 102,204,255


1111111111111111111
1000000000100000001
1000000000100000001
1000N00000100000001
1000000000100000001
1000000000100000001
1000000000100000001
1000000000100000001
1111111111111111111
