NO ./textures/1.xpm
SO ./textures/2.xpm
WE ./textures/3.xpm
EA ./textures/4.xpm

F 28,116,71
C 34,113,179

1111111111111111111
1110000000100000001
1000000000100000001
1000000W00100000001
1000000000000000001
1000011100111101111
1110000000100000001
1000000000100000001
1110000000111111111
1100000000000000001
1000000001100000001
1000000000000000001
1111111111111111111
