NO ./textures/1.xpm
SO ./textures/2.xpm
WE ./textures/5.xpm
EA ./textures/6.xpm

F 28,255,10
C 117,30,200


   11111 
  110001111111
11110001111111 1111111111111
11100000001001 1000000000001
1000000000100111000000100001
1000000N00100000001000000001
1000000000000000001111111111
1000011100111111111
11100000001001 1001
  110111111111 1111
  111111111111
