NO ./textures/wall_1.xpm
SO ./textures/wall_2.xpm
WE ./textures/wall_3.xpm
EA ./textures/wall_4.xpm

F 28,116,58
C 34,113,179


1111111111111111111
1110000000100000001
1000000000100000001
1000N00000100000001
1000000000000000001
1000011100111101111
1110000000100000001
1000000000100000001
1110000000111111111
1100000000000000001
1000000001100000001
1111111111111111111
